{
  "Width": 10,
  "Height": 10,
  "Loaded": true,
  "Current": "level1",
  "Unlocked": 1,
  "Grid": [
    [1, 1, 1, 1, 1, 1, 1, 1, 1, 1],
    [1, 0, 0, 0, 0, 0, 0, 0, 0, 1],
    [1, 0, 1, 0, 0, 0, 0, 0, 0, 1],
    [1, 0, 1, 1, 0, 0, 1, 0, 1, 1],
    [1, 0, 0, 0, 0, 0, 1, 0, 0, 1],
    [1, 0, 0, 0, 0, 0, 1, 0, 0, 1],
    [1, 0, 0, 0, 0, 0, 1, 0, 1, 1],
    [1, 0, 1, 0, 1, 1, 1, 0, 0, 1],
    [1, 0, 1, 0, 0, 0, 0, 0, 0, 1],
    [1, 1, 1, 1, 1, 1, 1, 1, 1, 1]
  ]
}
