{
  "Grid": [
    "AQEBAQEBAQEBAQEBAQEBAQEBAQ==",
    "AQMDAwMDAQMDAQMDAQMDAwMDAQ==",
    "AQMBAwADAAADAQMAAAMBAwEDAQ==",
    "AQMBAwEDAwMDAwMDAwMBAwEDAQ==",
    "AQMBAwEBAwABAQEAAwEBAwEDAQ==",
    "AQMDAwMBAwADAQMAAwEDAwMDAQ==",
    "AQAAAAMDAwADAQMAAwMDAAAAAQ==",
    "AQABAQMBAAAAAAAAAAEDAQEAAQ==",
    "AQABAAAAAAEBAgEBAAAAAAEAAQ==",
    "AQABAAAAAAEAAAABAAAAAAEAAQ==",
    "AQABAQAAAAEBAQEBAAAAAQEAAQ==",
    "AQMDAwMDAAAAAAAAAAMDAwMDAQ==",
    "AQEBAQEDAQEBAQEBAQMBAQEBAQ==",
    "AQMDAwAAAwMDAAMDAwAAAwMDAQ==",
    "AQMBAQAAAQEDAQMBAQAAAQEDAQ==",
    "AQMDAQAAAwMDAwMDAwAAAQMDAQ==",
    "AQEDAQAAAwEBAQEBAwAAAQMBAQ==",
    "AQMDAwAAAwMDAQMDAwAAAwMDAQ==",
    "AQMBAQAAAQEDAQMBAQAAAQEDAQ==",
    "AQMDAwADAwMDAwMDAwAAAwMDAQ==",
    "AQEBAQEBAQEBAQEBAQEBAQEBAQ=="
  ]
}